faciliter : to ease
apaiser : to mollify
assiégé : besieged
rauque/bruyant : raucous
malheur : a woe
lever : to lift
endémique : endemic
banal : mundane
restriction : a curb
intimidant : daunting
escalade/intensification : escalation
éparpillé : strewn
something that is no longer wanted : a castoff
piller : to loot
passage au crible : sifting
fret : freight
contrôler qqch : to juggle something
inventer une formule : to coin a term
congé : furlough
couper (ciseaux) : to snip
réforme/révision : an overhaul
échouer : to fall short
stabiliser : to steady
gaspiller/dilapider : to squander
vague/avalanche (de pb) : the spate of
sincère : wholehearted
stupéfait : stunned
stimuler/encourager : to spur
matériel (info) : hardware
entraînement militaire : military drills
claquer : to slam
groupe de réflexion : a think tank
victoire écrasante : a landslide victory
dénigrer : to rubbish
minimiser qqch : to play down smthg
réaliser : to carry out
soulager : to alleviate
conforme à : in line with
saisie : sequestration
réhabiliter : to renovate
revivifier/dynamiser : revitalize
exploiter qqch : to leverage smthg
dynamique/vibrant : vibrant
écoblanchiment : greenwashing
blanchiment d'argent sale : money laundering
contrebande/trafic : smuggling
tour de force / putsh : a coup
une plaie : a sore
être abbatu (mental) : to be abashed
à nouveau : anew
point de vue (physique) : vantage point
une annonce : a notice
planer : to hover
ronger/mâcher : to gnaw
commentateur : a pundit
lieu/site : venue
engagement : commitment
parrainage : sponsorship
enlever/déshabiller : to strip
accueilir qqch ou qqn : to host
dette souveraine : sovereign debt
la bourse : stock exchange
filiale : a subsidiary
oligarque : oligarch
primordial : paramount
flagrant : blatant
enfreindre : to breach
simplement/seulement : merely
à peine : barely
